%%%%%%%%%%%%%%%%%%%%%%%%%%%%%%%%%%%%%%%%%%%%%%%%%
% .  %        .%    % %      %  .%     % %   %  %
%    %%%% %%%%%% %  % % %%   %     %%%%% %. %%% %
%    %.%    % .% %  % %  %   %   %          %   %
%   .            %.     %%%% %   %% .%%% %      %
% %%%%% %%%%%%  %%%% %%          .%    %. %%%%%%%
%.      %   .%       .% %%%  % %%%%  % %  %   % %
%%% %%  % %%%%%%% %%%%% %    % %. %% % %    %.% %
%    %  %      %  %      P%%%% %     % % %%%% % %
%       %   %  %  %     %      %  %% %     .%   %
%%% %%%   .%%%    %%%%% %%% %% %  %.%%%%%%%%%%% %
%.  %    %    %              %    %             %
%%%%%%%%%%%%%%%%%%%%%%%%%%%%%%%%%%%%%%%%%%%%%%%%%
